Mudra Sova
An Interactive Fiction by Lucija
Release 1 / Serial number 211220 / Inform 7 build 6M62 (I6/v6.33 lib 6/12N) SD

Welcome to the interactive feature game!
Good morning, you are a student in the dorm room. 
Your task is to find the book you need to return to the library.

bedroom
You are very hungry, so look for money so you can buy bagel on the way to the library. You hear thunder, and it's raining hard outside. You see door but can't open them because they are magic and open only when you have money and book.

On the shelf is a picture.

You can also see a bed, a cabinet (closed), a white fridge (closed) and a table here.

>take bed
That's fixed in place.

>dop bed
That's not a verb I recognise.

>drop bed
Dropped.

* * *

>take bed
That's fixed in place.

>drop bed
Dropped.

* * *

>look fridge
Large white fridge. When you get closer you hear it working, making strange noises, it seems to be broken.

>look bed
Veliki krevet, takoder je ovdje.

* * *

>look fridge
Large white fridge. When you get closer you hear it working, making strange noises, it seems to be broken.

>open fridge
You open the white fridge, revealing a fruit.

>eat fruit
That's plainly inedible.

>take fruit
Voce nije jestivo, po njemu je vidljiva plijesan.

* * *

>look cabinet
Drveni ormar koji krije mnosto stvari usudi se istraziti sto se u njemu nalazi!

>open cabinet
You open the cabinet, revealing a bag.

>take money
Taken.

>inventory
You are carrying:
  a money

>look shelf
Obična drvena polica pričvršćena na zid.

On the Shelf is a Book.

>take book
Bravo! Sada imas knjigu.

>inventory
You are carrying:
  a Book
  a money

>close cabinet
You close the cabinet.

* * *

>open cabinet
You open the cabinet, revealing a bag.

>open bag
You open the bag, revealing a wallet.

>open wallet
You open the wallet, revealing a money.

>close cabinet
You close the cabinet.

>e cabinet
I only understood you as far as wanting to (go) e.

>examine cabinet
Drveni ormar koji krije mnosto stvari usudi se istraziti sto se u njemu nalazi!

* * *

>look
bedroom
Bok! Pa krenimo!

You can see a white fridge, a bed and a cabinet here.

>look shelf
Obična drvena polica pričvršćena na zid.

* * *

>look shelf
A metal shelf is attached to the wall and on it you can see many decorative things such as: candlesticks, scented candles, decorative angels...

On the shelf is a picture.

>take book
Bravo! Sada imas knjigu.

* * *

>look table
Radni stol na kojem se nalazi: laptop, papiri, kemijske..

>take table
That's hardly portable.

* * *

>look table
Radni stol na kojem se nalazi: laptop, papiri, kemijske..

>under table
That's not a verb I recognise.

>look under table
You find nothing of interest.

Obuj ih, trebat ce ti!

>look shelf
Obična drvena polica pričvršćena na zid.

On the Shelf is a Book.

>look boots
You can't see any such thing.

* * *

>look table
Radni stol na kojem se nalazi: laptop, papiri, kemijske..

>look under table
You find nothing of interest.

Obuj ih, trebat ce ti!

* * *

>look under table
Pronasao si cizme, idealne su za kisne dane u Varazdinu!

>take table
(the table)
That's fixed in place.

* * *

>look under table
Pronasao si cizme, idealne su za kisne dane u Varazdinu!

>inventory
You are carrying:
  a pair of boots under table

* * *

>look under table
Pronasao si cizme, idealne su za kisne dane u Varazdinu!

>look pair of boots
Smede cizme taman za kisne dane.

* * *

>look under table
Pronasao si cizme, idealne su za kisne dane u Varazdinu!

>take a pair of boots
You already have that.

>wear a pair of boots
You can't wear that!

* * *

>look under table
Pronasao si cizme, idealne su za kisne dane u Varazdinu!

>look boots
You can't see any such thing.

>wear boots
You put on the pair of boots under table.

>wears
That's not a verb I recognise.

>wear
(the pair of boots under table)
You're already wearing that!

* * *

>look boots
You can't see any such thing.

>take boots
You already have that.

* * *

>look under bed
Vidis samo strongbox! moras pronaci kljuc kako bi ga otvorio.

>look under table
You find nothing of interest.

Obuj ih, trebat ce ti!

* * *

>look under bed
Vidis samo strongbox! moras pronaci kljuc kako bi ga otvorio.

>look under the bed
You find nothing of interest.

* * *

>look under bed
Vidis samo strongbox! moras pronaci kljuc kako bi ga otvorio.

>look picture
Slika koja krije moci.

>take sandbox
You can't see any such thing.

>take picture
Podigli ste sliku i vidjeli ste ključ. 
 Stavite ključ u džep.

>look under bed
Knjiga je pronadena! Zahvaljujuci kljucu koji je omogucio da otvoris strongbox.

* * *

>look picture
Slika koja krije moci.

>take picture
Podigli ste sliku i vidjeli ste ključ. 
 Stavite ključ u džep.

* * *

>look under bed
Vidis samo strongbox! moras pronaci kljuc kako bi ga otvorio.

>take picture
Podigli ste sliku i ugledali ste ključ. 
Stavite ključ u džep.

>open cabinet
You open the cabinet, revealing bag and a raincoat.

>open bag
You open bag, revealing a wallet.

>open raincoat
It isn't something you can open.

>take raincoat
Taken.

>e
Nisi otkrio gdje je novac niti knjigu ne mozes ic dalje

>take money
You can't see any such thing.

>open wallet
You open the wallet, revealing a money.

>take money
Bravo! Pronašao si 100 kuna.

>look under bed
Knjiga je pronadena! Zahvaljujuci kljucu koji je omogucio da otvoris strongbox.

>e
hall
Hodnik kroz koji prolazis sad ces doci na ulicu.

Uzeo si novac i knjigu, sada si u hodnik. Kreni istočno na ulicu.

>e
Sada oblacis kabanicu da se ne razbolis!

Street
Na ulici se nalazi park, drvece, cvijece, kanta za smece..

You can see four roses, six daisies, three lilies and a tree (on which is a paper (in which is a message)) here.

>e
Bakery
Pekara Mlinar koja nudi razna peciva.

You can see a Baker here.

>e
Library
Ako zelis zavrsiti igru uspjesno moras odgovoriti na pitanje. Koje godine je izumljen inform?

>e
You can't go that way.

>a
aThat's not a verb I recognise.

* * *

>take pair of boots
You can't see any such thing.

>inventory
You are carrying nothing.

* * *

>take cabinet
That's fixed in place.

* * *

>e
You haven't found out where the money and the book is so you can't go on.

>take book
Bravo! Sada imas knjigu.

>e
Nisi uzeo novac, ne možeš ić u hodnik.

bedroom
Bok! Pa krenimo!

You can see a bed, a cabinet (closed) and a white fridge (closed) here.

>drop book
Dropped.

>take money
You can't see any such thing.

>open cabinet
You open the cabinet, revealing a money.

>take money
Taken.

>e
hall

* * *

>take book
Bravo! Sada imas knjigu.

>take money
You can't see any such thing.

* * *

>take money
Taken.

>inventory
You are carrying:
  a money
  a Book

>e
hall
Uzeo si novac i knjigu, mozes ic u hodnik.

>e
Street

>w
hall
Uzeo si novac i knjigu, mozes ic u hodnik.

>e
Street

* * *

>take book
Bravo! Sada imas knjigu.

>open cabinet
You open the cabinet, revealing bag and a raincoat.

* * *

>open bag
You open bag, revealing a wallet.

>open wallet
You open the wallet, revealing a money.

* * *

>take money
Bravo! Pronašao si 100 kuna.

>e
hall
Hodnik kroz koji prolazis sad ces doci na ulicu.

Uzeo si novac i knjigu, sada si u hodnik. Kreni istočno na ulicu.

* * *

>e
You haven't found out where the money and the book is so you can't go on.

>open cabinet
You open the cabinet, revealing bag and a raincoat.

>e
Nisi otkrio gdje je novac niti knjigu ne mozes ic dalje

>take money
Taken.

>e
Nisi uzeo novac, ne možeš ić u hodnik.

bedroom
Bok! Pa krenimo!

On the Shelf is a Book.

You can also see a bed, a cabinet (empty) and a white fridge (closed) here.

* * *

>e
Nisi otkrio gdje je novac niti knjigu ne mozes ic dalje

>open bag
You open bag, revealing a wallet.

* * *

>take money
Bravo! Pronašao si 100 kuna.

>e
Nisi uzeo knjigu, ne možeš ić u hodnik.

>take book
Bravo! Sada imas knjigu.

>e
hall
Hodnik kroz koji prolazis sad ces doci na ulicu.

Uzeo si novac i knjigu, sada si u hodnik. Kreni istočno na ulicu.

>e
Pajdo nemas kabanicu.

* * *

>e
You haven't found out where the money and the book is so you can't go on.

>open hall
You can't see any such thing.

>open cabinet
You open the cabinet, revealing a money.

* * *

>take money
Taken.

>e
Nisi uzeo knjigu, ne možeš ić u hodnik.

* * *

>take book
Bravo! Sada imas knjigu.

>e
hall
Uzeo si novac i knjigu, mozes ic u hodnik.

* * *

>e
You haven't found out where the money and the book is so you can't go on.

>take moeny
You can't see any such thing.

>open cabinet
You open the cabinet, revealing bag and a raincoat.

* * *

>take money
Bravo! Pronašao si 100 kuna.

>take book
Bravo! Sada imas knjigu.

* * *

>e
Pajdo nemas kabanicu.

>w
bedroom
Nalazite se u studentskoj sobi. Jaka kisa pada, morate pronaci kabanicu.

You can see a bed, a cabinet (in which are bag (in which is a wallet (empty)) and a raincoat), a white fridge (closed) and a table here.

>take raincoat
Taken.

>e
hall
Hodnik kroz koji prolazis sad ces doci na ulicu.

Uzeo si novac i knjigu, sada si u hodnik. Kreni istočno na ulicu.

>e
Sada oblacis kabanicu da se ne razbolis!

Street
Na ulici se nalazi park, drvece, cvijece, kanta za smece..

>i
You are carrying:
  a raincoat (being worn)
  a book
  a money

>w
hall
Hodnik kroz koji prolazis sad ces doci na ulicu.

Uzeo si novac i knjigu, sada si u hodnik. Kreni istočno na ulicu.

>drop raincoat
(first taking the raincoat off)
Dropped.

>i
You are carrying:
  a book
  a money

>e
Pajdo nemas kabanicu.

>w
bedroom
Nalazite se u studentskoj sobi. Jaka kisa pada, morate pronaci kabanicu.

You can see a bed, a cabinet (in which is bag (in which is a wallet (empty))), a white fridge (closed) and a table here.

>e
hall
Hodnik kroz koji prolazis sad ces doci na ulicu.

You can see a raincoat here.

Uzeo si novac i knjigu, sada si u hodnik. Kreni istočno na ulicu.

>take raincoat
Taken.

>wear raincoat
You put on the raincoat.

>e
Kisa pljusti, ali kabanica te stiti od kise!

Street
Na ulici se nalazi park, drvece, cvijece, kanta za smece..

I beg your pardon?

* * *

>take moeny
You can't see any such thing.

>take picture
You picked up the picture and saw the brass key.  Keep the key in your pocket.

>open cabinet
You open the cabinet, revealing bag and a raincoat.

* * *

>open wallet
You open the wallet, revealing a money.

>take money
Well done, you found the money I think you are on the good way.

>take raincoat
Taken.

>e
You didn't find the book, you can't go down the hall.

>look under bed
Thanks to the key that enabled you to open the strongbox, you discovered the book.

>e
hall
There is only a trash can in the hallway, the walls are blueand the tiles are cube-shaped gray.

You took the money and the book, now you're in the hall. Head east onto the street. Through the window you see the storm getting worse

>e
Now you are putting raincoat so you don't get sick!

street
On the street you see trees, buildings, a bell tower, cars, bicycles...

You can see five violets, six anemones, ten saffrons and a tree (on which is a paper (in which is a message)) here.

>e
bakery
The bakery has a variety of pastries, three tables and six chairs, a refrigerator with milk, yogurt, juices.. If you have money you can buy a bagel now.

You can see a Baker here.

>e
narrow passage
A little more and you're done. You are in a narrow passage. Continue east toward the library.

The wise owl is covered with gray-white feathers, has large eyes and large wings. The owl will not let you go because it is awake and waiting for your answer.

>e
An owl appears in the narrow passage to the library and asks you: In what year did Inform 7 first appear?

Enter the answer:

* * *

>1
That's not a verb I recognise.

>1
That's not a verb I recognise.

>e
library

>drop book
*** You have succesed! ***

Would you like to RESTART, RESTORE a saved game, QUIT or UNDO the last command?

* * *

>e
You haven't found out where the money and the book is so you can't go on.

>take picture
You picked up the picture and saw the brass key.  Keep the key in your pocket.

>e
Nisi otkrio gdje je novac niti knjigu ne mozes ic dalje

>open cabinet
You open the cabinet, revealing bag and a raincoat.

>open wallet
You can't see any such thing.

>open bag
You open bag, revealing a wallet.

* * *

>e
Nisi uzeo knjigu, ne možeš ić u hodnik.

>take picture
Vratite sliku na njeno mjesto prije nego Vam ispadne.

>inventory
You are carrying:
  a money
  a Silver Key

>take raincoat
Taken.

>look under bed
Knjiga je pronadena! Zahvaljujuci kljucu koji je omogucio da otvoris strongbox.

* * *

>e
Bakery
Pekara Mlinar koja nudi razna peciva.

You can see a Baker here.

>e
Library
Ako zelis zavrsiti igru uspjesno moras odgovoriti na pitanje. Koje godine je izumljen inform?

However, a robot the size of an Arcturan megaladon guards the way.

>e
The robot steps in front of you as you approach the gate. "PAASSWAAAAWRD!!" it bellows.

Enter password:

>eeee
"WRONG PASSWAAARD!" roars the robot. "CHECK CAPS LAAAWWWWK!"

>xyzzy
That's not a verb I recognise.

>e
The robot steps in front of you as you approach the gate. "PAASSWAAAAWRD!!" it bellows.

Enter password:

>e
"WRONG PASSWAAARD!" roars the robot. "CHECK CAPS LAAAWWWWK!"

>e
The robot steps in front of you as you approach the gate. "PAASSWAAAAWRD!!" it bellows.

Enter password:

>xyzzy
The robot folds itself up into a cube to let you pass.

Kitchen

* * *

>take picture
You picked up the picture and saw the brass key.  Keep the key in your pocket.

>look under bed
Thanks to the key that enabled you to open the strongbox, you discovered the book.

>open cabinet
You open the cabinet, revealing bag and a raincoat.

>opne bag
That's not a verb I recognise.

>open bag
You open bag, revealing a wallet.

* * *

>take money
Well done, you found the money I think you are on the good way.

>e
hall
There is only a trash can in the hallway, the walls are blueand the tiles are cube-shaped gray.

You took the money and the book, now you're in the hall. Head east onto the street. Through the window you see the storm getting worse

>w
bedroom
You are very hungry, so look for money so you can buy bagel on the way to the library. You hear thunder, and it's raining hard outside.

On the shelf is a picture.

You can also see a bed, a cabinet (in which are bag (in which is a wallet (empty)) and a raincoat), a white fridge (closed) and a table here.

>take money
You already have that.

>take raincoat
Taken.

>e
hall
There is only a trash can in the hallway, the walls are blueand the tiles are cube-shaped gray.

You took the money and the book, now you're in the hall. Head east onto the street. Through the window you see the storm getting worse

* * *

>e
bakery
The bakery has a variety of pastries, three tables and six chairs, a refrigerator with milk, yogurt, juices.. If you have money you can buy a bagel now.

You can see a Baker here.

>buy bagel
Bon appetit!

>eat bagel
All right, you're fed up now, you're going out on a narrow passage.

narrow passage
A little more and you're done. You are in a narrow passage. 
 Continue east toward the library.

The wise owl is covered with gray-white feathers, has large eyes and large wings.

>w
bakery
The bakery has a variety of pastries, three tables and six chairs, a refrigerator with milk, yogurt, juices.. If you have money you can buy a bagel now.

You can see a Baker here.

>e
narrow passage
A little more and you're done. You are in a narrow passage. 
 Continue east toward the library.

The wise owl is covered with gray-white feathers, has large eyes and large wings.

* * *

>e
You haven't found out where the money and the book is so you can't go on.

>take pictute
You can't see any such thing.

>take picture
You picked up the picture and saw the brass key.  Keep the key in your pocket.

* * *

>w
bedroom
You are very hungry, so look for money so you can buy bagel on the way to the library. You hear thunder, and it's raining hard outside.

On the shelf is a picture.

You can also see a bed, a cabinet (in which are bag (in which is a wallet (empty)) and a raincoat), a white fridge (closed) and a table here.

>take raincoat
Taken.

* * *

>e
bakery
The bakery has a variety of pastries, three tables and six chairs, a refrigerator with milk, yogurt, juices.. If you have money you can buy a bagel now.

You can see a Baker here.

>e
narrow passage
A little more and you're done. You are in a narrow passage. Continue east toward the library.

The wise owl is covered with gray-white feathers, has large eyes and large wings. A cube of metal the size of an Arctural megaladon snores loudly.

>ee
That's not a verb I recognise.

>look owl
*** Game over. ***

Would you like to RESTART, RESTORE a saved game, QUIT or UNDO the last command?

* * *

>open closet
You can't see any such thing.

>look closet
You can't see any such thing.

>open cabinet
You open the cabinet, revealing a money.

* * *

>inventory
You are carrying:
  a money

>e
hall
Uzeo si novac, mozes ic u hodnik.

* * *

>open closet
You can't see any such thing.

>open cabinet
You open the cabinet, revealing a money.

* * *

>e
Nisi uzeo novac, ne možeš ić u hodnik.

bedroom
Bok! Pa krenimo!

On the Shelf is a Book.

You can also see a bed, a cabinet (empty) and a white fridge (closed) here.

>take book
Bravo! Sada imas knjigu.

* * *

>hall
That's not a verb I recognise.

>e
hall

>w
bedroom
Bok! Pa krenimo!

On the Shelf is a Book.

You can also see a bed, a cabinet (closed) and a white fridge (closed) here.

>take book
Bravo! Sada imas knjigu.

>open cabinet
You open the cabinet, revealing a money.

* * *

>take money
Taken.

>e
hall
Uzeo si novac, mozes ic u hodnik.

* * *

>take book
Bravo! Sada imas knjigu.

* * *

>take money
Taken.

>e
hall
Uzeo si novac i knjigu, sada si u hodnik. Kreni istočno na ulicu.

>e
Street
Na ulici se nalazi park, drvece, cvijece, kanta za smece..

>e
Bakery
Pekara Mlinar koja nudi razna peciva.

You can see a Baker here.

>ask Baker
What do you want to ask the Baker for?

>cake
The Baker has better things to do.

>buy cake
The Baker doesn't seem interested.

Dobar tek ti želim!

>eat cake
You eat the cake. Not bad.

* * *

>e
Bakery
Pekara Mlinar koja nudi razna peciva.

You can see a Baker here.

>buy cake
The Baker doesn't seem interested.

Dobar tek ti zelim!

>inventory
You are carrying:
  a cake
  a money
  a Book

>eat cake
Library

* * *

>open cabinet
You open the cabinet, revealing bag and a raincoat.

>take money
Taken.

* * *

>e
Bakery
Pekara Mlinar koja nudi razna peciva.

You can see a Baker here.

>buy cake
The Baker doesn't seem interested.

>buy the cake
The Baker doesn't seem interested.

>ineventory
That's not a verb I recognise.

>inventory
You are carrying:
  a money
  a Book

>give money to the Baker
The Baker doesn't seem interested.

>take cake
That seems to belong to the Baker.

* * *

>take money
Bravo! Pronašao si 100 kuna.

>take raincoat
Taken.

>e
hall
Uzeo si novac i knjigu, sada si u hodnik. Kreni istočno na ulicu.

>e
Smocicesse

* * *

>take money
Bravo! Pronašao si 100 kuna.

>e
hall
Uzeo si novac i knjigu, sada si u hodnik. Kreni istočno na ulicu.

>e
Pajdo nemas kabanicu.

>e
Bakery
Pekara Mlinar koja nudi razna peciva.

You can see a Baker here.

>w
Pajdo nemas kabanicu.

>w
hall
Uzeo si novac i knjigu, sada si u hodnik. Kreni istočno na ulicu.

>w
bedroom
Nalazite se u studentskoj sobi. Jaka kisa pada, morate pronaci kabanicu.

You can see a bed, a cabinet (in which are bag (in which is a wallet (empty)) and a raincoat), a white fridge (closed) and a table here.

* * *

>e
hall
Uzeo si novac i knjigu, sada si u hodnik. Kreni istočno na ulicu.

>e
Sada oblacis kabanicu da se ne razbolis!

>i
You are carrying:
  a raincoat (being worn)
  a money
  a book

>look stret
You can't see any such thing.

>look street
You can't see any such thing.

>examine street
You can't see any such thing.

>look
Street
Na ulici se nalazi park, drvece, cvijece, kanta za smece..

* * *

>take book
Bravo! Sada imas knjigu.

>open cabonet
You can't see any such thing.

>open bag
You can't see any such thing.

>open cabinet
You open the cabinet, revealing bag and a raincoat.

* * *

>take money
Bravo! Pronašao si 100 kuna.

>take book
You already have that.

>take raincoat
Taken.

* * *

>e
Smocicesse

>i
You are carrying:
  a raincoat (being worn)
  a money
  a book

* * *

>open cabinet
You open the cabinet, revealing bag and a raincoat.

* * *

>take money
Taken.

>take book
Bravo! Sada imas knjigu.

>e
hall
Uzeo si novac i knjigu, sada si u hodnik. Kreni istočno na ulicu.

* * *

>buy cake
The Baker doesn't seem interested.

>give money
(to the Baker)
The Baker doesn't seem interested.

>inventory
You are carrying:
  a cake
  a Book
  a money

* * *

>take money
Well done, you found the money I think you are on the good way.

>take book
Bravo! Sada imas knjigu.

>wear raincoat
(first taking the raincoat)
You put on the raincoat.

>i
You are carrying:
  a raincoat (being worn)
  a book
  a money

>e
hall
Uzeo si novac i knjigu, sada si u hodnik. Kreni istočno na ulicu.

>e
Kabanica te stiti od kise!

* * *

>e
Pajdo nemas kabanicu.

>w
hall
Uzeo si novac i knjigu, sada si u hodnik. Kreni istočno na ulicu.

* * *

>take raincoat
Taken.

>i
You are carrying:
  a raincoat
  a book
  a money

>e
hall
Uzeo si novac i knjigu, sada si u hodnik. Kreni istočno na ulicu.

* * *

>e
Bakery
Pekara Mlinar koja nudi razna peciva.

You can see a Baker here.

* * *

>e
Pajdo nemas kabanicu.

>e
Pajdo nemas kabanicu.

* * *

>take money
Well done, you found the money I think you are on the good way.

>wear raincoat
(first taking the raincoat)
You put on the raincoat.

>i
You are carrying:
  a raincoat (being worn)
  a money

>take book
Bravo! Sada imas knjigu.

* * *

>e
hall
Uzeo si novac i knjigu, sada si u hodnik. Kreni istočno na ulicu.

>e
Kisa pljusti, ali kabanica te stiti od kise!
Zaboravio si ponijeti kabanicu sada ces se smociti kao pivac!

* * *

>take money
Well done, you found the money I think you are on the good way.

>e
Nisi uzeo knjigu, ne možeš ić u hodnik.

* * *

>e
Pajdo nemas kabanicu.

>w
hall
Hodnik kroz koji prolazis sad ces doci na ulicu.

Uzeo si novac i knjigu, sada si u hodnik. Kreni istočno na ulicu.

>w
bedroom
Nalazite se u studentskoj sobi. Jaka kisa pada, morate pronaci kabanicu.

You can see a bed, a cabinet (in which are bag (in which is a wallet (empty)) and a raincoat), a white fridge (closed) and a table here.

* * *

>wear raincoat
You put on the raincoat.

>e
hall
Hodnik kroz koji prolazis sad ces doci na ulicu.

Uzeo si novac i knjigu, sada si u hodnik. Kreni istočno na ulicu.

>e
Kisa pljusti, ali kabanica te stiti od kise!
Pajdo nemas kabanicu.

>i
You are carrying:
  a raincoat (being worn)
  a book
  a money

* * *

>e
Nisi uzeo knjigu, ne možeš ić u hodnik.

>take picture
Podigli ste sliku i ugledali ste ključ. 
Stavite ključ u džep.

>look under bed
Knjiga je pronadena! Zahvaljujuci kljucu koji je omogucio da otvoris strongbox.

* * *

>e
Pajdo nemas kabanicu.

>w
bedroom
Nalazite se u studentskoj sobi. Jaka kisa pada, morate pronaci kabanicu.

On the shelf is a picture.

You can also see a bed, a cabinet (in which are bag (in which is a wallet (empty)) and a raincoat), a white fridge (closed) and a table here.

>take raincoat
Taken.

* * *

>e
Sada oblacis kabanicu da se ne razbolis!

Street
Na ulici se nalazi park, drvece, cvijece, kanta za smece..

You can see four roses, six daisies, three lilies and a tree (on which is a paper (in which is a message)) here.

>look tree
On the tree is a paper (in which is a message).

>look paper
In the paper is a message.

>look message
Kreni istocno prema pekari.

>e
Bakery
Pekara Mlinar koja nudi razna peciva.

You can see a Baker here.

* * *

>take money
Well done, you found the money I think you are on the good way.

>open picture
It isn't something you can open.

>take picture
Podigli ste sliku i ugledali ste ključ. 
Stavite ključ u džep.

* * *

>e
hall
Hodnik kroz koji prolazis sad ces doci na ulicu.

Uzeo si novac i knjigu, sada si u hodnik. Kreni istočno na ulicu.

>w
bedroom
Nalazite se u studentskoj sobi. Jaka kisa pada, morate pronaci kabanicu.

On the shelf is a picture.

You can also see a bed, a cabinet (in which are bag (in which is a wallet (empty)) and a raincoat), a white fridge (closed) and a table here.

* * *

>e
Library
Ako zelis zavrsiti igru uspjesno moras odgovoriti na pitanje. Koje godine je izumljen inform?

>193
That's not a verb I recognise.

>1972
I didn't understand that sentence.

>1972 godine
Bravo! pogodio si.

* * *

>take money
Well done, you found the money I think you are on the good way.

>inventory
You are carrying nothing.

* * *

>take money
Well done, you found the money I think you are on the good way.

>look under bed
You only see the strongbox! You have to find the key to open it.

>take picture
You picked up the picture and saw the brass key.  Keep the key in your pocket.

* * *

>e
hall
There is only a trash can in the hallway, the walls are blueand the tiles are cube-shaped gray.

You took the money and the book, now you're in the hall. Head east onto the street. Through the window you see the storm getting worse

>e
You don't have a raincoat, go back to the room if you don't want to get wet.

>e
You don't have a raincoat, go back to the room if you don't want to get wet.

>w
bedroom
You are very hungry, so look for money so you can buy bagel on the way to the library. You hear thunder, and it's raining hard outside.

On the shelf is a picture.

You can also see a bed, a cabinet (in which are bag (in which is a wallet (empty)) and a raincoat), a white fridge (closed) and a table here.

* * *

>take money
Well done, you found the money I think you are on the good way.

>take picture
You picked up the picture and saw the brass key.  Keep the key in your pocket.

>look under ba
You can't see any such thing.

>look under bed
Thanks to the key that enabled you to open the strongbox, you discovered the book.

>take raincoat
Taken.

* * *

>e
narrow passage
A little more and you're done. You are in a narrow passage. Continue east toward the library.

The wise owl is covered with gray-white feathers, has large eyes and large wings. A cube of metal the size of an Arctural megaladon snores loudly.

>e
An owl appears in the narrow passage to the library and asks you: In what year did Inform 7 first appear?

Enter the answer:

* * *

>e
*** Loser! Mislio si da ces me prevariti sova te je pustila ali zaboravio si ono najbitnije knjigu.  ***

Would you like to RESTART, RESTORE a saved game, QUIT or UNDO the last command?

* * *

>e
bakery
The bakery has a variety of pastries, three tables and six chairs, a refrigerator with milk, yogurt, juices.. If you have money you can buy a bagel now.

You can see a Baker here.

>e
narrow passage
A little more and you're done. You are in a narrow passage. 
 Continue east toward the library.

The wise owl is covered with gray-white feathers, has large eyes and large wings.

>e
An owl appears in front of you the narrow passage to the library and asks you: In what year did Inform 7 first appear?

Enter the answer:

>333
The owl has steal book. Try to catch owl.

>w
bakery
The bakery has a variety of pastries, three tables and six chairs, a refrigerator with milk, yogurt, juices.. If you have money you can buy a bagel now.

You can see a Baker here.

>drop book
You can't see any such thing.

>e
narrow passage
A little more and you're done. You are in a narrow passage. 
 Continue east toward the library.

The wise owl is covered with gray-white feathers, has large eyes and large wings.

>e
*** Loser! Mislio si da ces me prevariti sova te je pustila ali zaboravio si ono najbitnije knjigu.  ***

Would you like to RESTART, RESTORE a saved game, QUIT or UNDO the last command?

* * *

>take raincoat
Taken.

>take picture
You picked up the picture and saw the brass key.  Keep the key in your pocket.

* * *

>e
bakery
The bakery has a variety of pastries, three tables and six chairs, a refrigerator with milk, yogurt, juices.. If you have money you can buy a bagel now.

You can see a Baker here.

>drop book
Dropped.

>e
narrow passage
A little more and you're done. You are in a narrow passage. 
 Continue east toward the library.

The wise owl is covered with gray-white feathers, has large eyes and large wings.

* * *

>take money
Well done, you found the money I think you are on the good way.

>look bed
On the wooden bed there is a pink pillow, a brown blanket, colorful pajamas, a plush monkey toy and a pile of clothes.

>look under bed
You only see the strongbox! You have to find the key to open it.

>look picture
In the picture we see white and red roses, a green stem covered with thorns.

>take picture
You picked up the picture and saw the brass key.  Keep the key in your pocket.

* * *

>e
Now you are putting raincoat so you don't get sick!

street
On the street you see trees, buildings, a bell tower, cars, bicycles...

You can see five violets, six anemones, ten saffrons and a tree (on which is a paper (in which is a message)) here.

>look paper
In the paper is a message.

>read message
MESSAGE: Head east toward the bakery.

>e
bakery
The bakery has a variety of pastries, three tables and six chairs, a refrigerator with milk, yogurt, juices.. If you have money you can buy a bagel now.

You can see a Baker here.

>ask Baker about bagel
It costs 10 kuna.

>buy bagel
Bon appetit!

* * *

>eat bagel
All right, you're fed up now, you're going out on a narrow passage.

narrow passage
A little more and you're done. You are in a narrow passage. 
 Continue east toward the library.

The wise owl is covered with gray-white feathers, has large eyes and large wings.

>e
An owl appears in front of you the narrow passage to the library and asks you: In what year did Inform 7 first appear?

Enter the answer:

>3444
The owl has steal book. Try to catch owl.

>catch owl
*** You can't catch me, yet I fly very very fast!. GAME OVER ***

Would you like to RESTART, RESTORE a saved game, QUIT or UNDO the last command?

* * *

>open wallet
You open the wallet, revealing a money.

>examine money
You see nothing special about the money.

>take money
Bravo! Pronašao si 100 kuna.

* * *

>open wallet
You open the wallet, revealing a money.

>take raincoat
Taken.

* * *

>e
Nisi otkrio gdje je novac niti knjigu ne mozes ic dalje

>take money
Bravo! Pronašao si 100 kuna.

* * *

>open wallet
You open the wallet, revealing a money.

>e
Nisi otkrio gdje je novac niti knjigu ne mozes ic dalje

>take picture
Podigli ste sliku i ugledali ste ključ. 
Stavite ključ u džep.

* * *

>look under bed
Knjiga je pronadena! Zahvaljujuci kljucu koji je omogucio da otvoris strongbox.

>e
Nisi uzeo novac, ne možeš ić u hodnik.

>take money
Bravo! Pronašao si 100 kuna.

* * *

>e
Sada oblacis kabanicu da se ne razbolis!

Street
Na ulici se nalazi park, drvece, cvijece, kanta za smece..

You can see four roses, six daisies, three lilies and a tree (on which is a paper (in which is a message)) here.

>read paper
In the paper is a message.

>read message
Kreni istocno prema pekari.

>e
Bakery
Pekara Mlinar koja nudi razna peciva.

You can see a Baker here.

>dobar dan
That's not a verb I recognise.

>Dobar dan
That's not a verb I recognise.

>say Dobar dan
(to the Baker)
There is no reply.

>Pecivo
That's not a verb I recognise.

>buy cake
The Baker doesn't seem interested.

Dobar tek ti zelim!

>eat cake
Library
Ako zelis zavrsiti igru uspjesno moras odgovoriti na pitanje. Koje godine je izumljen inform?

However, a robot the size of an Arcturan megaladon guards the way.

>e
The robot steps in front of you as you approach the gate. "PAASSWAAAAWRD!!" it bellows.

Enter password:

>dfsdfs
"WRONG PASSWAAARD!" roars the robot. "CHECK CAPS LAAAWWWWK!"

>e
The robot steps in front of you as you approach the gate. "PAASSWAAAAWRD!!" it bellows.

Enter password:

* * *

>open wallet
You open the wallet, revealing a money.

>take picture
You picked up the picture and saw the brass key.  Keep the key in your pocket.

* * *

>look under bed
Thanks to the key that enabled you to open the strongbox, you discovered the book.

>e
You didn't take the money, you can't go down the hall.

>take money
Well done, you found the money I think you are on the good way.

>e
hall
There is only a trash can in the hallway, the walls are blueand the tiles are cube-shaped gray.

You took the money and the book, now you're in the hall. Head east onto the street.

>e
You don't have a raincoat, go back to the room if you don't want to get wet or move on.

Street
On the street you see trees, buildings, a bell tower, cars, bicycles...

You can see four roses, six daisies, three lilies and a tree (on which is a paper (in which is a message)) here.

>e
Bakery
Pekara Mlinar koja nudi razna peciva.

You can see a Baker here.

>w
You don't have a raincoat, go back to the room if you don't want to get wet or move on.

Street
On the street you see trees, buildings, a bell tower, cars, bicycles...

You can see four roses, six daisies, three lilies and a tree (on which is a paper (in which is a message)) here.

>eat rouses
You can't see any such thing.

>eat rose
The rosy scent tickles your nose.

* * *

>e
Nisi otkrio gdje je novac niti knjigu ne mozes ic dalje

>take book
Bravo! Sada imas knjigu.

>open wallet
You open the wallet, revealing a money.

* * *

>open bag
You open bag, revealing a wallet.

>open waller
You can't see any such thing.

>open wallet
You open the wallet, revealing a money.

* * *

>take raincoat
Taken.

>take picture
Podigli ste sliku i ugledali ste ključ. 
Stavite ključ u džep.

* * *

>look tree
On the tree is a paper (in which is a message).

>look paper
Kreni istocno prema pekari.

In the paper is a message.

* * *

>take money
Bravo! Pronašao si 100 kuna.

>take picture
Podigli ste sliku i ugledali ste ključ. 
Stavite ključ u džep.

* * *

>e
Library
Ako zelis zavrsiti igru uspjesno moras odgovoriti na pitanje. Koje godine je izumljen inform?

>a
aThat's not a verb I recognise.

* * *

>open bag
You open bag, revealing a wallet.

>open walllet
You can't see any such thing.

>open wallet
You open the wallet, revealing a money.

* * *

>take raincoat
Taken.

>look under bed
You only see the strongbox! You have to find the key to open it.

>e
You didn't find the book, you can't go down the hall.

>e
You didn't find the book, you can't go down the hall.

>take picture
You picked up the picture and saw the brass key.  Keep the key in your pocket.

>e
You didn't find the book, you can't go down the hall.

* * *

>inventory
You are carrying:
  a brass key
  a raincoat (being worn)
  a money

>catch
I didn't understand that sentence.

>Catch
I didn't understand that sentence.

>Catch owl
*** Ne mozes me uhvatiti. ***

Would you like to RESTART, RESTORE a saved game, QUIT or UNDO the last command?

* * *

>open cabinet
You open the cabinet, revealing bag and a raincoat.

>wear raincoat
(first taking the raincoat)
You put on the raincoat.

>i
You are carrying:
  a raincoat (being worn)

* * *

>open cabinet
You open the cabinet, revealing bag and a raincoat.

>take raincoat
Taken.

* * *

>wear raincoat
You put on the raincoat.

>i
You are carrying:
  a raincoat (being worn)

>open bag
You open bag, revealing a wallet.

* * *

>e
hall
Uzeo si novac i knjigu, sada si u hodnik. Kreni istočno na ulicu.

>e
Zaboravio si ponijeti kabanicu sada ces se smociti kao pivac!

>i
You are carrying:
  a book
  a money
  a raincoat (being worn)

* * *

>take raincoat
Taken.

>i
You are carrying:
  a raincoat

>e
Nisi otkrio gdje je novac niti knjigu ne mozes ic dalje

>open cabinet
That's already open.

>open bag
You open bag, revealing a wallet.

* * *

>take book
Bravo! Sada imas knjigu.

>open bag
You open bag, revealing a wallet.

* * *

>e
Nisi otkrio gdje je novac niti knjigu ne mozes ic dalje

>take boo
You can't see any such thing.

>take book
Bravo! Sada imas knjigu.

* * *

>e
Smocicesse

>i
You are carrying:
  a money
  a book

>e
Bakery
Pekara Mlinar koja nudi razna peciva.

You can see a Baker here.

>w
Smocicesse

>w
hall
Uzeo si novac i knjigu, sada si u hodnik. Kreni istočno na ulicu.

>e
Smocicesse

>w
hall
Uzeo si novac i knjigu, sada si u hodnik. Kreni istočno na ulicu.

* * *

>w
bedroom
Nalazite se u studentskoj sobi. Jaka kisa pada, morate pronaci kabanicu.

You can see a bed, a cabinet (in which are bag (in which is a wallet (empty)) and a raincoat), a white fridge (closed) and a table here.

>e
hall
Uzeo si novac i knjigu, sada si u hodnik. Kreni istočno na ulicu.

* * *

>take raincoat
Taken.

>w
You can't go that way.

>e
hall
Uzeo si novac i knjigu, sada si u hodnik. Kreni istočno na ulicu.

* * *

>e
Smocicesse

>i
You are carrying:
  a raincoat
  a money
  a book

>put raincoat
What do you want to put the raincoat in?

>take raincoat
You already have that.

>wear raincoat
You put on the raincoat.

>i
You are carrying:
  a raincoat (being worn)
  a money
  a book

* * *

>under bed
That's not a verb I recognise.

>look bed
Veliki krevet na kojem se nalazi smeda dekica.

>under bed
That's not a verb I recognise.

>in bed
I only understood you as far as wanting to (go) in.

>look under bed
You find nothing of interest.

>look on the bed
You can't see any such thing.

>look book
Našao si knjigu koju treba vratiti!

>look table
Radni stol na kojem se nalazi: laptop, papiri, kemijske..

* * *

>under bed
That's not a verb I recognise.

>look under bed
Knjiga je pronadena!

* * *

>look under the table
Pronasao si cizme, idealne su za kisne dane u Varazdinu!

>wear the boots
You put on the pair of boots under table.

* * *

>look pair of boots
You can't see any such thing.

* * *

>look boots
You can't see any such thing.

>look under table
Pronasao si cizme, idealne su za kisne dane u Varazdinu!

* * *

>examine table
Radni stol na kojem se nalazi: laptop, papiri, kemijske..

* * *

>take raincoat
You can't see any such thing.

>open cabinet
You open the cabinet, revealing bag and a raincoat.

* * *

>take book
Bravo! Sada imas knjigu.

>take raincoat
Taken.

* * *

>take picture
You picked up the picture and saw the brass key.  Keep the key in your pocket.

* * *

>look under bed
Thanks to the key that enabled you to open the strongbox, you discovered the book.

>inventory
You are carrying:
  a book
  a Silver Key

* * *

>e
bakery
The bakery has a variety of pastries, three tables and six chairs, a refrigerator with milk, yogurt, juices.. If you have money you can buy a bagel now.

You can see a Baker here.

>buy cake
The Baker doesn't seem interested.

Dobar tek ti zelim!

>e
Library

>w
Bakery
Pekara Mlinar koja nudi razna peciva.

You can see a Baker here.

>inventory
You are carrying:
  a cake
  a raincoat (being worn)
  a money
  a book
  a Silver Key

>eat cake
Library

* * *

>w
bakery
The bakery has a variety of pastries, three tables and six chairs, a refrigerator with milk, yogurt, juices.. If you have money you can buy a bagel now.

You can see a Baker here.

>e
narrow passage
A little more and you're done. You are in a narrow passage. Continue east toward the library.

The wise owl is covered with gray-white feathers, has large eyes and large wings. The owl will not let you go because it is awake and waiting for your answer.

>e
library

* * *

I beg your pardon?

>e
library

* * *

>e
hall
There is only a trash can in the hallway, the walls are blueand the tiles are cube-shaped gray.

You took the money and the book, now you're in the hall. Head east onto the street. Through the window you see the storm getting worse

>drop money
Dropped.

>e
Now you are putting raincoat so you don't get sick!

street
On the street you see trees, buildings, a bell tower, cars, bicycles...

You can see five violets, six anemones, ten saffrons and a tree (on which is a paper (in which is a message)) here.

* * *

>e
bakery
The bakery has a variety of pastries, three tables and six chairs, a refrigerator with milk, yogurt, juices.. If you have money you can buy a bagel now.

You can see a Baker here.

>buy bagel
You lost money you can't buy bagel.

>e
narrow passage
A little more and you're done. You are in a narrow passage. 
 Continue east toward the library.

The wise owl is covered with gray-white feathers, has large eyes and large wings.

>w
bakery
The bakery has a variety of pastries, three tables and six chairs, a refrigerator with milk, yogurt, juices.. If you have money you can buy a bagel now.

You can see a Baker here.

>w
It's raining, but the raincoat protects you from the rain!

street
On the street you see trees, buildings, a bell tower, cars, bicycles...

You can see five violets, six anemones, ten saffrons and a tree (on which is a paper (in which is a message)) here.

>e
bakery
The bakery has a variety of pastries, three tables and six chairs, a refrigerator with milk, yogurt, juices.. If you have money you can buy a bagel now.

You can see a Baker here.

* * *

>e
narrow passage
A little more and you're done. You are in a narrow passage. Continue east toward the library.

The wise owl is covered with gray-white feathers, has large eyes and large wings. A cube of metal the size of an Arctural megaladon snores loudly.

>er
That's not a verb I recognise.

>a
That's not a verb I recognise.

>a
That's not a verb I recognise.

* * *

>e
narrow passage
A little more and you're done. You are in a narrow passage. Continue east toward the library.

The wise owl is covered with gray-white feathers, has large eyes and large wings. A cube of metal the size of an Arctural megaladon snores loudly.

>12321
That's not a verb I recognise.

>455
That's not a verb I recognise.

>open
What do you want to open?

>take money
*** Game over. ***

Would you like to RESTART, RESTORE a saved game, QUIT or UNDO the last command?

* * *

>e
bakery
The bakery has a variety of pastries, three tables and six chairs, a refrigerator with milk, yogurt, juices.. If you have money you can buy a bagel now.

You can see a Baker here.

>buy bagel
The Baker doesn't seem interested.

Bon appetit!

>w
It's raining, but the raincoat protects you from the rain!

street
On the street you see trees, buildings, a bell tower, cars, bicycles...

You can see five violets, six anemones, ten saffrons and a tree (on which is a paper (in which is a message)) here.

* * *

>e
Now you are putting raincoat so you don't get sick!

street
On the street you see trees, buildings, a bell tower, cars, bicycles...

You can see five violets, six anemones, ten saffrons and a tree (on which is a paper (in which is a message)) here.

>drop money
Dropped.

>e
bakery
The bakery has a variety of pastries, three tables and six chairs, a refrigerator with milk, yogurt, juices.. If you have money you can buy a bagel now.

You can see a Baker here.

* * *

>buy bagel
You lost money you can't buy bagel.

>w
It's raining, but the raincoat protects you from the rain!

street
On the street you see trees, buildings, a bell tower, cars, bicycles...

You can see a money, five violets, six anemones, ten saffrons and a tree (on which is a paper (in which is a message)) here.

>e
bakery
The bakery has a variety of pastries, three tables and six chairs, a refrigerator with milk, yogurt, juices.. If you have money you can buy a bagel now.

You can see a Baker here.

>e
Bye.

narrow passage
A little more and you're done. You are in a narrow passage. 
 Continue east toward the library.

The wise owl is covered with gray-white feathers, has large eyes and large wings.

* * *

>e
hall
There is only a trash can in the hallway, the walls are blueand the tiles are cube-shaped gray.

You took the money and the book, now you're in the hall. Head east onto the street. Through the window you see the storm getting worse

I beg your pardon?

>e
You don't have a raincoat, go back to the room if you don't want to get wet.

* * *

>e
An owl appears in the narrow passage to the library and asks you: In what year did Inform 7 first appear?

Enter the answer:

>1212
That's not a verb I recognise.

Enter the answer:

>2006
The owl has calmed down and is no longer flying around you.

library

* * *

>e
bakery
The bakery has a variety of pastries, three tables and six chairs, a refrigerator with milk, yogurt, juices.. If you have money you can buy a bagel now.

You can see a Baker here.

>ee
That's not a verb I recognise.

>e
narrow passage
A little more and you're done. You are in a narrow passage. Continue east toward the library.

The wise owl is covered with gray-white feathers, has large eyes and large wings. The owl will not let you go because it is awake and waiting for your answer.

* * *

>e
An owl appears in the narrow passage to the library and asks you: In what year did Inform 7 first appear?

Enter the answer:

>2323
That's not a verb I recognise.

Enter the answer:

>2006
The owl has calmed down and is no longer flying around you.

library
That's not a verb I recognise.

* * *

>e
An owl appears in the narrow passage to the library and asks you: In what year did Inform 7 first appear?

Enter the answer:

>123
Enter the answer:

>1233
Enter the answer:

* * *

>e
bakery
The bakery has a variety of pastries, three tables and six chairs, a refrigerator with milk, yogurt, juices.. If you have money you can buy a bagel now.

You can see a Baker here.

>e
Bye.

* * *

>open wallet
You open the wallet, revealing a money.

>e
You didn't take the money, you can't go down the hall.

* * *

>ask Baker about Dobar dan
Dobar dan. Sto zelite jesti?

>ask Baker about Pecivo
Izvolite. To je 10 kuna.

>buy cake
The Baker doesn't seem interested.

Dobar tek ti zelim!

>Baker inventory
That's not a verb I recognise.

>inventory
You are carrying:
  a cake
  a raincoat (being worn)
  a money
  a book
  a Silver Key

* * *

>e
library

* * *

>e
hall
There is only a trash can in the hallway, the walls are blueand the tiles are cube-shaped gray.

You took the money and the book, now you're in the hall. Head east onto the street. Through the window you see the storm getting worse

>e
Now you are putting raincoat so you don't get sick!

Street
On the street you see trees, buildings, a bell tower, cars, bicycles...

You can see five violets, six anemones, ten saffrons and a tree (on which is a paper (in which is a message)) here.

>eat anemnone
You can't see any such thing.

>eat anemone
The flower is not edible, it is very bitter and may be poisonous!

>eat saffron
The flower is not edible, it is very bitter and may be poisonous!

>eat flower
Which do you mean, a violet, an anemone or a saffron?

>eat violet
Violet look really nice, but unfortunately they are not edible.

>eat flower
Which do you mean, a violet, an anemone or a saffron?

>violet
Violet look really nice, but unfortunately they are not edible.

>eat flower
Which do you mean, a violet, an anemone or a saffron?

>anemone
The flower is not edible, it is very bitter and may be poisonous!

>eat saffron
The flower is not edible, it is very bitter and may be poisonous!

* * *

>e
An owl appears in the narrow passage to the library and asks you: In what year did Inform 7 first appear?

Enter the answer:

>2006
The owl has calmed down and is no longer flying around you.

library

* * *

>open wallet
You open the wallet, revealing a money.

>open fridge
You open the white fridge, revealing a banana, an orange and an apple.

>eat banana
The fruit is not edible by it is visible mold..

>e
You didn't take the money, you can't go down the hall.

* * *

>e
You don't have a raincoat, go back to the room if you don't want to get wet.

>w
bedroom
You are very hungry, so look for money so you can buy bagel on the way to the library. You hear thunder, and it's raining hard outside.

On the shelf is a picture.

You can also see a bed, a cabinet (in which are bag (in which is a wallet (empty)) and a raincoat), a white fridge (in which are a banana, an orange and an apple) and a table here.

>take raincoat
Taken.

* * *

>e
Now you are putting raincoat so you don't get sick!

street
On the street you see trees, buildings, a bell tower, cars, bicycles...

You can see five violets, six anemones, ten saffrons and a tree (on which is a paper (in which is a message)) here.

>read message
Head east toward the bakery.

>eat tree
That's plainly inedible.

>eat message
That's plainly inedible.

>e
bakery
The bakery has a variety of pastries, three tables and six chairs, a refrigerator with milk, yogurt, juices..

You can see a baker here.

* * *

>open wallet
You open the wallet, revealing a money.

>take moeny
You can't see any such thing.

>take money
Well done, you found the money I think you are on the good way.

* * *

>e
An owl appears in the narrow passage to the library and asks you: In what year did Inform 7 first appear?

Enter the answer:

>122
>122

I beg your pardon?

* * *

>open wallet
You open the wallet, revealing a money.

>open walet
You can't see any such thing.

>open wallet
That's already open.

>take money
Well done, you found the money I think you are on the good way.

* * *

>e
An owl appears in front of you the narrow passage to the library and asks you: In what year did Inform 7 first appear?

Enter the answer:

>2006
The owl has asleep. Keep moving to the east.

library

>w
narrow passage
A little more and you're done. You are in a narrow passage. 
 Continue east toward the library.

The wise owl is covered with gray-white feathers, has large eyes and large wings.

>e
An owl appears in front of you the narrow passage to the library and asks you: In what year did Inform 7 first appear?

Enter the answer:

>2222
The owl has steal book. Try to catch owl.

>catch owl
*** Ne mozes me uhvatiti niti ubiti ja sam najbrza. ***

Would you like to RESTART, RESTORE a saved game, QUIT or UNDO the last command?

>RESTART
Probni
An Interactive Fiction by Lucija
Release 1 / Serial number 211208 / Inform 7 build 6M62 (I6/v6.33 lib 6/12N) SD

Welcome to the interactive feature game!
Good morning, you are a student in the dorm room. 
Your task is to find the book you need to return to the library.

bedroom
You are very hungry, so look for money so you can buy bagel on the way to the library. You hear thunder, and it's raining hard outside.

On the shelf is a picture.

You can also see a bed, a cabinet (closed), a white fridge (closed) and a table here.

>OPEN CABINET
You open the cabinet, revealing bag and a raincoat.

>open bag
You open bag, revealing a wallet.

* * *

>e
You didn't find the book, you can't go down the hall.

>look under bed
You only see the strongbox! You have to find the key to open it.

>look bed
On the wooden bed there is a pink pillow, a brown blanket, colorful pajamas, a plush monkey toy and a pile of clothes.

>take picture
You picked up the picture and saw the brass key.  Keep the key in your pocket.

* * *

>take raincoat
Taken.

>e
You didn't take the money, you can't go down the hall.

>take money
You can't see any such thing.

* * *

>e
An owl appears in the narrow passage to the library and asks you: In what year did Inform 7 first appear?

Enter the answer:

>13123
That's not a verb I recognise.

Enter the answer:

>2323
That's not a verb I recognise.

Enter the answer:

>2006
The owl has calmed down and is no longer flying around you.

library
That's not a verb I recognise.

Enter the answer:

>2006
The owl has calmed down and is no longer flying around you.

library
That's not a verb I recognise.

Enter the answer:

* * *

>take raincoat
Taken.

>open wallet
You open the wallet, revealing a money.

* * *

>e
You didn't take the money, you can't go down the hall.

>open cabinet
You open the cabinet, revealing bag and a raincoat.

* * *

>e
hall
Hodnik kroz koji prolazis sad ces doci na ulicu.

Uzeo si novac i knjigu, sada si u hodnik. Kreni istočno na ulicu.

>e
Sada oblacis kabanicu da se ne razbolis!

Street
Na ulici se nalazi park, drvece, cvijece, kanta za smece..

You can see four roses, six daisies and three lilies here.

>look tree
You can't see any such thing.

>look the tree
You can't see any such thing.

>examine
What do you want to examine?

>examine tree
You can't see any such thing.

>look on the tree
You can't see any such thing.

* * *

>e
An owl appears in the narrow passage to the library and asks you: In what year did Inform 7 first appear?

Enter the answer:

>123
"WRONG ANSWER!" says the owl.
That's not a verb I recognise.

Enter the answer:

>2006
The owl has calmed down and is no longer flying around you.

library
That's not a verb I recognise.

Enter the answer:

>e
"WRONG ANSWER!" says the owl.

    *** GAME OVER YOU DIDN'T READ THE BOOK. ***

Would you like to RESTART, RESTORE a saved game, QUIT or UNDO the last command?

* * *

>look under bed
Thanks to the key that enabled you to open the strongbox, you discovered the book.

>open bag
You can't see any such thing.

* * *

>e
hall
There is only a trash can in the hallway, the walls are blueand the tiles are cube-shaped gray.

You took the money and the book, now you're in the hall. Head east onto the street. Through the window you see the storm getting worse

>e
Now you are putting raincoat so you don't get sick!

Street
On the street you see trees, buildings, a bell tower, cars, bicycles...

You can see five violets, six anemones, three anemnone and a tree (on which is a paper (in which is a message)) here.

>eat violet
Violet look really nice, but unfortunately they are not edible.

>eat anemnone
That's plainly inedible.

* * *

>look under bed
Thanks to the key that enabled you to open the strongbox, you discovered the book.

>take raincoat
You can't see any such thing.

* * *

>take raincoat
Taken.

>open bag
You open bag, revealing a wallet.

* * *

>ee
That's not a verb I recognise.

>2006
The owl has calmed down and is no longer flying around you.

library
That's not a verb I recognise.

* * *

>take money
Well done, you found the money I think you are on the good way.

>e
You didn't find the book, you can't go down the hall.

>look under bad
You can't see any such thing.

>look under bed
Knjiga je pronadena! Zahvaljujuci kljucu koji je omogucio da otvoris strongbox.

>take raincoat
Taken.

* * *

>e
You didn't find the book, you can't go down the hall.

>take picture
Put the picture back in its place before you break it. It would be a shame to break such a work of art.

>look under bed
Thanks to the key that enabled you to open the strongbox, you discovered the book.

* * *

>w
bedroom
You are very hungry, so look for money so you can buy bagel on the way to the library. You hear thunder, and it's raining hard outside.

On the shelf is a picture.

You can also see a bed, a cabinet (in which are bag (in which is a wallet (empty)) and a raincoat), a white fridge (closed) and a table here.

>take raincaoat
You can't see any such thing.

>e
hall
There is only a trash can in the hallway, the walls are blueand the tiles are cube-shaped gray.

You took the money and the book, now you're in the hall. Head east onto the street. Through the window you see the storm getting worse

* * *

>buy bagel
Bon appetit!

>w
It's raining, but the raincoat protects you from the rain!

street
On the street you see trees, buildings, a bell tower, cars, bicycles...

You can see five violets, six anemones, ten saffrons and a tree (on which is a paper (in which is a message)) here.

* * *

>e
bakery
The bakery has a variety of pastries, three tables and six chairs, a refrigerator with milk, yogurt, juices.. If you have money you can buy a bagel now.

You can see a Baker here.

>buy bagel
Nothing is on sale.

* * *

>e
An owl appears in the narrow passage to the library and asks you: In what year did Inform 7 first appear?

Enter the answer:

>123
That's not a verb I recognise.

Enter the answer:

>2006
The owl has calmed down and is no longer flying around you.

library

>drop book
*** You hav csuccesed! ***

Would you like to RESTART, RESTORE a saved game, QUIT or UNDO the last command?

* * *

>take picture
Put the picture back in its place before you break it. It would be a shame to break such a work of art.

>e
You didn't find the book, you can't go down the hall.

* * *

>take money
Well done, you found the money I think you are on the good way.

>look under bed
Thanks to the key that enabled you to open the strongbox, you discovered the book.

* * *

>e
An owl appears in the narrow passage to the library and asks you: In what year did Inform 7 first appear?

Enter the answer:

>2006
The owl has calmed down and is no longer flying around you.

* * *

>take money
Well done, you found the money I think you are on the good way.

>take picture
Put the picture back in its place before you break it. It would be a shame to break such a work of art.

>take raincoat
Taken.

>look under bed
Thanks to the key that enabled you to open the strongbox, you discovered the book.

* * *

>e
An owl appears in front of you the narrow passage to the library and asks you: In what year did Inform 7 first appear?

Enter the answer:

>2006
The owl has asleep.

>e
An owl appears in front of you the narrow passage to the library and asks you: In what year did Inform 7 first appear?

Enter the answer:

* * *

>look under bed
Thanks to the key that enabled you to open the strongbox, you discovered the book.

>e
hall
There is only a trash can in the hallway, the walls are blueand the tiles are cube-shaped gray.

You took the money and the book, now you're in the hall. Head east onto the street.

>e
Now you are putting raincoat so you don't get sick!

Street
On the street you see trees, buildings, a bell tower, cars, bicycles...

You can see four roses, six daisies, three lilies and a tree (on which is a paper (in which is a message)) here.

>w
hall
There is only a trash can in the hallway, the walls are blueand the tiles are cube-shaped gray.

You took the money and the book, now you're in the hall. Head east onto the street.

>w
bedroom
You are very hungry, so look for money so you can buy bagel on the way to the library. You hear thunder, and it's raining hard outside.

On the shelf is a picture.

You can also see a bed, a cabinet (in which is bag (in which is a wallet (empty))), a white fridge (closed) and a table here.

>drop raincoat
(first taking the raincoat off)
Dropped.

>e
hall
There is only a trash can in the hallway, the walls are blueand the tiles are cube-shaped gray.

You took the money and the book, now you're in the hall. Head east onto the street.

>e
Pajdo nemas kabanicu.

* * *

>take picture
You picked up the picture and saw the brass key.  Keep the key in your pocket.

>e
You haven't found out where the money and the book is so you can't go on.

* * *

>take picture
You picked up the picture and saw the brass key.  Keep the key in your pocket.

>open bag
You can't see any such thing.

* * *

>open wallet
You can't see any such thing.

>take money
You can't see any such thing.

>open bag
You open bag, revealing a wallet.

* * *

>e
An owl appears in the narrow passage to the library and asks you: In what year did Inform 7 first appear?

Enter the answer:

>1213
That's not a verb I recognise.

Enter the answer:

>2006
The owl has calmed down and is no longer flying around you.

library
That's not a verb I recognise.

Enter the answer:

>123
That's not a verb I recognise.

Enter the answer:

* * *

>take picture
You picked up the picture and saw the brass key.  Keep the key in your pocket.

>open bed
It isn't something you can open.

>open cabinet
You open the cabinet, revealing bag and a raincoat.

* * *

>take picture
You picked up the picture and saw the brass key.  Keep the key in your pocket.

>look unde rbed
You can't see any such thing.

>look under bed
Thanks to the key that enabled you to open the strongbox, you discovered the book.

* * *

>e
bakery
The bakery has a variety of pastries, three tables and six chairs, a refrigerator with milk, yogurt, juices.. If you have money you can buy a bagel now.

You can see a Baker here.

>e
You stayed hungry because you lost money.

narrow passage
A little more and you're done. You are in a narrow passage. 
 Continue east toward the library.

The wise owl is covered with gray-white feathers, has large eyes and large wings.

>w
bakery
The bakery has a variety of pastries, three tables and six chairs, a refrigerator with milk, yogurt, juices.. If you have money you can buy a bagel now.

You can see a Baker here.

>e
You stayed hungry because you lost money.

narrow passage
A little more and you're done. You are in a narrow passage. 
 Continue east toward the library.

The wise owl is covered with gray-white feathers, has large eyes and large wings.

* * *

>w
bakery
The bakery has a variety of pastries, three tables and six chairs, a refrigerator with milk, yogurt, juices.. If you have money you can buy a bagel now.

You can see a Baker here.

>w
It's raining, but the raincoat protects you from the rain!

street
On the street you see trees, buildings, a bell tower, cars, bicycles...

You can see a money, five violets, six anemones, ten saffrons and a tree (on which is a paper (in which is a message)) here.

>take money
Well done, you found the money I think you are on the good way.

>e
bakery
The bakery has a variety of pastries, three tables and six chairs, a refrigerator with milk, yogurt, juices.. If you have money you can buy a bagel now.

You can see a Baker here.

>e
You stayed hungry because you don't want to spend money.

narrow passage
A little more and you're done. You are in a narrow passage. 
 Continue east toward the library.

The wise owl is covered with gray-white feathers, has large eyes and large wings.

>w
bakery
The bakery has a variety of pastries, three tables and six chairs, a refrigerator with milk, yogurt, juices.. If you have money you can buy a bagel now.

You can see a Baker here.

* * *

>w
It's raining, but the raincoat protects you from the rain!

street
On the street you see trees, buildings, a bell tower, cars, bicycles...

You can see five violets, six anemones, ten saffrons and a tree (on which is a paper (in which is a message)) here.

>drop money
Dropped.

* * *

>buy bagel
You lost money you can't buy bagel.

>e
You stayed hungry because you lost money.

narrow passage
A little more and you're done. You are in a narrow passage. 
 Continue east toward the library.

The wise owl is covered with gray-white feathers, has large eyes and large wings.

* * *

>w
bakery
The bakery has a variety of pastries, three tables and six chairs, a refrigerator with milk, yogurt, juices.. If you have money you can buy a bagel now.

You can see a Baker here.

>buy bagel
Bon appetit!

>e
narrow passage
A little more and you're done. You are in a narrow passage. 
 Continue east toward the library.

The wise owl is covered with gray-white feathers, has large eyes and large wings.

* * *

>w
bakery
The bakery has a variety of pastries, three tables and six chairs, a refrigerator with milk, yogurt, juices.. If you have money you can buy a bagel now.

You can see a Baker here.

>buy bagel
Nothing is on sale.

>e
narrow passage
A little more and you're done. You are in a narrow passage. 
 Continue east toward the library.

The wise owl is covered with gray-white feathers, has large eyes and large wings.

* * *

>w
bakery
The bakery has a variety of pastries, three tables and six chairs, a refrigerator with milk, yogurt, juices.. If you have money you can buy a bagel now.

You can see a Baker here.

>eat bagel
All right, you're fed up now, you're going out on a narrow passage.

narrow passage
A little more and you're done. You are in a narrow passage. 
 Continue east toward the library.

The wise owl is covered with gray-white feathers, has large eyes and large wings.

* * *

>take picture
You picked up the picture and saw the brass key.  Keep the key in your pocket.

>look under picture
You find nothing of interest.

>open cabinet
You open the cabinet, revealing bag and a raincoat.

* * *

>buy bagel
Bon appetit!

>e
Okay, eat bagel when you want you don't have to eat in the bakery.

narrow passage
A little more and you're done. You are in a narrow passage. 
 Continue east toward the library.

The wise owl is covered with gray-white feathers, has large eyes and large wings.

>w
bakery
The bakery has a variety of pastries, three tables and six chairs, a refrigerator with milk, yogurt, juices.. If you have money you can buy a bagel now.

You can see a Baker here.

* * *

>buy bagel
Nothing is on sale.

>e
Okay, eat bagel when you want you don't have to eat in the bakery.

narrow passage
A little more and you're done. You are in a narrow passage. 
 Continue east toward the library.

The wise owl is covered with gray-white feathers, has large eyes and large wings.

* * *

>take picture
You picked up the picture and saw the brass key.  Keep the key in your pocket.

>take key
You already have that.

>open cabinet
You open the cabinet, revealing bag and a raincoat.

* * *

>e
bakery
The bakery has a variety of pastries, three tables and six chairs, a refrigerator with milk, yogurt, juices.. If you have money you can buy a bagel now.

You can see a Baker here.

>w
It's raining, but the raincoat protects you from the rain!

street
On the street you see trees, buildings, a bell tower, cars, bicycles...

You can see five violets, six anemones, ten saffrons and a tree (on which is a paper (in which is a message)) here.

>read message
MESSAGE: Head east toward the bakery.

* * *

>e
bakery
The bakery has a variety of pastries, three tables and six chairs, a refrigerator with milk, yogurt, juices.. If you have money you can buy a bagel now.

You can see a Baker here.

>bagel
That's not a verb I recognise.

>ask Baker about bagel
It costs 10 kuna.

* * *

>buy bagel
Bon appetit!

>e
Okay, eat bagel when you want you don't have to eat in the bakery.

narrow passage
A little more and you're done. You are in a narrow passage. 
Continue east toward the library.

The wise owl is covered with gray-white feathers, has large eyes and large wings.

>w
bakery
The bakery has a variety of pastries, three tables and six chairs, a refrigerator with milk, yogurt, juices.. If you have money you can buy a bagel now.

You can see a Baker here.

>e
Okay, eat bagel when you want you don't have to eat in the bakery.

narrow passage
A little more and you're done. You are in a narrow passage. 
Continue east toward the library.

The wise owl is covered with gray-white feathers, has large eyes and large wings.

>eat bagel
You eat the bagel. Not bad.

>e
An owl appears in front of you the narrow passage to the library and asks you: In what year did Inform 7 first appear?

Enter the answer:

>2006
The owl has asleep. Keep moving to the east.

library
Well done! You've reached to the library. The library contains a lot of books, chairs, desks with laptops, a lot of people and a desk behind which is a librarian. All you have to do is drop the book and you're done.

>drop book
*** You have succeeded! ***

Would you like to RESTART, RESTORE a saved game, QUIT or UNDO the last command?

* * *

>take shelf
That's hardly portable.

>examine shelf
Obična drvena polica pričvršćena na zid.

On the shelf are a book and a picture.

>take picture
Podigli ste sliku i vidjeli ste ključ. 
. Stavite ključ u džep.

* * *

>look bed
On the wooden bed there is a pink pillow, a brown blanket, colorful pajamas, a plush monkey toy and a pile of clothes.

>look under the bed
You find nothing of interest.

* * *

>look picture
Slika koja krije moci.

>take picture
Podigli ste sliku i ugledali ste ključ. 
 Stavite ključ u džep.

>look under the bed
You find nothing of interest.

>look under
(the Silver Key)
You find nothing of interest.

>look under bed
You find nothing of interest.

* * *

>take picture
Podigli ste sliku i ugledali ste ključ. 
 Stavite ključ u džep.

>look under bed
Knjiga je pronadena! Zahvaljujuci kljucu koji je omogucio da otvoris strongbox.

* * *

>e
Nisi uzeo novac, ne možeš ić u hodnik.

>open cabinet
You open the cabinet, revealing bag and a raincoat.

* * *

>e
Sada oblacis kabanicu da se ne razbolis!

Street
Na ulici se nalazi park, drvece, cvijece, kanta za smece..

You can see four roses, six daisies and three lilies here.

>eat flower
Which do you mean, a rose, a daisy or a lily?

>eat rose
The rosy scent tickles your nose.

>eat daisy
You feel light-headed.

>eat lily
It tastes bitter and you feel woozy.

* * *

>1972
That's not a verb I recognise.

* * *

>grab
That's not a verb I recognise.

>grab
That's not a verb I recognise.

>a
That's not a verb I recognise.

* * *

>look answer
You can't see any such thing.

* * *

>a
That's not a verb I recognise.

* * *

>ka
That's not a verb I recognise.

>open kabinet
You can't see any such thing.

>open cabinet
*** Uspj. ***

Would you like to RESTART, RESTORE a saved game, QUIT or UNDO the last command?

* * *

>open fridge
You open the white fridge, revealing a banana, an orange and an apple.

>eat fruit
You can't see any such thing.

>eat banana
That's plainly inedible.

>eat orange
That's plainly inedible.

>eat apple
That's plainly inedible.

* * *

>open fridge
You open the white fridge, revealing a banana, an orange and an apple.

>eat banana
The fruit is not edible by it is visible mold.

>look under bed
You only see the strongbox! You have to find the key to open it.

* * *

>look under bed
Thanks to the key that enabled you to open the strongbox, you discovered the book.

>look book
The book has a thick cover, and it has the title: Inform 7

>e
You didn't take the money, you can't go down the hall.

* * *

>e
Now you are putting raincoat so you don't get sick!

street
On the street you see trees, buildings, a bell tower, cars, bicycles...

You can see five violets, six anemones, ten saffrons and a tree (on which is a paper (in which is a message)) here.

>eat violet
Violets look really nice, but unfortunately they are not edible.

>eat flower
Which do you mean, a violet, an anemone or a saffron?

>saffron
Saffron smells very nice, but are not edible.

>read message
MESSAGE: Head east toward the bakery.

* * *

>e
bakery
The bakery has a variety of pastries, three tables and six chairs, a refrigerator with milk, yogurt, juices.. If you have money you can buy a bagel now.

You can see a Baker here.

>ask baker about bagel
It costs 10 kuna.

>buy bagel
Bon appetit!

>inventory
You are carrying:
  a bagel
  a raincoat (being worn)
  a book
  a brass key

>e
Okay, eat bagel when you want you don't have to eat in the bakery.

narrow passage
A little more and you're done. You are in a narrow passage. 
 Continue east toward the library.

The wise owl is covered with gray-white feathers, has large eyes and large wings.

>eat bagel
All right, you're fed up now, you're going out on a narrow passage.

narrow passage
A little more and you're done. You are in a narrow passage. 
 Continue east toward the library.

The wise owl is covered with gray-white feathers, has large eyes and large wings.

* * *

>e
An owl appears in front of you the narrow passage to the library and asks you: In what year did Inform 7 first appear?

Enter the answer:

>123
The owl has steal book. Try to catch owl.

>catch owl
*** You can't catch me, yet I fly very very fast!. GAME OVER ***

Would you like to RESTART, RESTORE a saved game, QUIT or UNDO the last command?

>RESTART
Probni
An Interactive Fiction by Lucija
Release 1 / Serial number 211209 / Inform 7 build 6M62 (I6/v6.33 lib 6/12N) SD

Welcome to the interactive feature game!
Good morning, you are a student in the dorm room. 
Your task is to find the book you need to return to the library.

bedroom
You are very hungry, so look for money so you can buy bagel on the way to the library. You hear thunder, and it's raining hard outside.

On the shelf is a picture.

You can also see a bed, a cabinet (closed), a white fridge (closed) and a table here.

>LOOK UNDER bed
You only see the strongbox! You have to find the key to open it.

>take picture
You picked up the picture and saw the brass key.  Keep the key in your pocket.

* * *

>e
Okay, eat bagel when you want you don't have to eat in the bakery.

narrow passage
A little more and you're done. You are in a narrow passage. 
 Continue east toward the library.

The wise owl is covered with gray-white feathers, has large eyes and large wings.

>e
An owl appears in front of you the narrow passage to the library and asks you: In what year did Inform 7 first appear?

Enter the answer:

* * *

>2006
The owl has asleep. Keep moving to the east.

library

>e
You can't go that way.

I beg your pardon?

>w
Okay, eat bagel when you want you don't have to eat in the bakery.

narrow passage
A little more and you're done. You are in a narrow passage. 
 Continue east toward the library.

The wise owl is covered with gray-white feathers, has large eyes and large wings.

>w
bakery
The bakery has a variety of pastries, three tables and six chairs, a refrigerator with milk, yogurt, juices.. If you have money you can buy a bagel now.

You can see a Baker here.

>drop book
Dropped.

>e
Okay, eat bagel when you want you don't have to eat in the bakery.

narrow passage
A little more and you're done. You are in a narrow passage. 
 Continue east toward the library.

The wise owl is covered with gray-white feathers, has large eyes and large wings.

>e
*** You meant to fool me, but you lost a book along the way. GAME OVER ***

Would you like to RESTART, RESTORE a saved game, QUIT or UNDO the last command?

* * *

>open bag
You can't see any such thing.

* * *

>open wallet
You open the wallet, revealing a money.

>open wallet
That's already open.

* * *

>e
Now you are putting raincoat so you don't get sick!

Street
On the street you see trees, buildings, a bell tower, cars, bicycles...

You can see five violets, six anemones, ten saffrons and a tree (on which is a paper (in which is a message)) here.

>eat flower
Which do you mean, a violet, an anemone or a saffron?

>violet
Violets look really nice, but unfortunately they are not edible.

>eat anemone
Anemones resembles a daisy, but it is not edible, but unfortunately they are not edible.

>eat flower
Which do you mean, a violet, an anemone or a saffron?

* * *

>saffron
Saffron smells very nice, but are not edible.

>eat violet
Violets look really nice, but unfortunately they are not edible.

>e
Bakery
Pekara Mlinar koja nudi razna peciva.

You can see a Baker here.

* * *

>take money
You can't see any such thing.

>take picture
You picked up the picture and saw the brass key.  Keep the key in your pocket.

* * *

>open raincoat
It isn't something you can open.

>e
You haven't found out where the money and the book is so you can't go on.

>take raincoat
Taken.

* * *

>e
You didn't take the money, you can't go down the hall.

>e
You didn't take the money, you can't go down the hall.

* * *

>take money
You can't see any such thing.

>e
You didn't take the money, you can't go down the hall.

>open wallet
You open the wallet, revealing a money.

* * *

>e
An owl appears in the narrow passage to the library and asks you: In what year did Inform 7 first appear?

Enter the answer:

>123
"WRONG ANSWER!" says the owl.

Enter the answer:

>1233
"WRONG ANSWER!" says the owl.

Enter the answer:

>3
"WRONG ANSWER!" says the owl.

Enter the answer:

* * *

>TAKE PICTURE
You picked up the picture and saw the brass key.  Keep the key in your pocket.

>look under bed
Thanks to the key that enabled you to open the strongbox, you discovered the book.

* * *

>w
bedroom
You are very hungry, so look for money so you can buy bagel on the way to the library. You hear thunder, and it's raining hard outside.

On the shelf is a picture.

You can also see a bed, a cabinet (in which are bag (in which is a wallet (empty)) and a raincoat), a white fridge (closed) and a table here.

>take raindrop
You can't see any such thing.

>take raincoat
Taken.

* * *

>e
narrow passage
A little more and you're done. You are in a narrow passage. 
 Continue east toward the library.

The wise owl is covered with gray-white feathers, has large eyes and large wings.

>e
*** You meant to fool me, but you lost a book along the way. GAME OVER ***

Would you like to RESTART, RESTORE a saved game, QUIT or UNDO the last command?

* * *

>look bedroom
You can't see any such thing.